eu=I
bonito=beautiful
a=the
bem=good
aceitou=accepted
assino=sign
cavalos=horses
brincar=to play
correndo=running
clovis=clovis
da=of the
de=of
daqui=from here
escolheram=chose
e=and
diante=against
dois=two
escolares=school
sou=am
filho=son
farao=will do
exercicios=Exercises
fazenda=Finance
oi=hi
o=The
goku=goku
garota=girl
formarao=will form
garotos=boys
na=in the
mata=jungle
governo=government
governasse=rule
lhe=him
januario=januario
lanche=lunch
martim=martim
mais=more
meus=my
meu=my
minha=my
ministro=Minister
nao=No
oito=eight
os=the
rua=Street
resolveram=decide
presidente=president
pediram=asked
para=for
pagara=will pay
pois=because
por=by
que=what
seguranca=security
sera=will be
todos=all
voces=you
